24 16
12 4 4 4 4 5 12 5 12 4 4 4 4 4 4 4 4 4 4 5 12 4 4 5 
10 2 0 0 2 3 8 1 8 0 2 2 2 2 2 2 2 2 0 1 8 0 0 1 
12 4 0 1 12 5 8 0 0 1 12 4 4 4 4 4 4 4 0 1 8 0 0 1 
8 0 0 1 8 1 8 0 2 3 8 0 2 2 0 0 2 2 2 3 8 0 0 1 
8 0 0 1 8 0 0 1 12 4 0 0 4 5 8 0 4 4 4 4 0 0 0 1 
8 0 0 1 8 1 8 1 8 0 0 0 0 1 8 0 2 2 2 2 2 0 0 3 
8 0 2 3 8 1 8 1 8 0 0 0 0 1 8 1 12 4 4 4 4 0 0 5 
8 0 4 4 0 1 8 1 10 2 0 0 2 3 8 1 8 0 2 2 2 2 2 3 
8 0 0 0 0 1 8 0 4 4 0 0 4 4 0 1 8 1 12 4 4 4 4 5 
8 0 2 2 2 3 10 2 2 2 2 2 2 2 2 3 8 1 8 0 0 0 0 1 
8 0 4 4 4 4 4 4 4 4 4 4 4 4 4 4 0 0 0 0 0 0 0 1 
10 2 2 2 2 0 0 2 2 2 2 2 2 0 0 0 0 0 0 0 0 0 0 1 
12 4 4 4 4 0 0 4 4 4 5 12 5 8 0 0 0 1 8 0 0 0 0 1 
8 0 0 0 0 0 0 0 0 0 1 8 1 8 0 0 0 1 8 0 0 0 0 1 
8 0 0 0 0 0 0 0 0 0 1 8 0 0 0 0 0 1 8 0 0 0 0 1 
10 2 2 2 2 2 2 2 2 2 3 10 2 2 2 2 2 3 10 2 2 2 2 3 
